7 10
|--------|
|.F.|..-.|
|..-|.@P.|
|.F....-.|
|.------.|
|........|
|--------|